Cruise Ship	Cruise Line	Score 
Adonia	P&O Cruises	98
Adventure of the Seas	Royal Caribbean International	90
AIDAaura	Aida Cruises	86
AIDABella	Aida Cruises	98
AIDAdiva	Aida Cruises	100
AIDAluna	Aida Cruises	99
AIDAmar	Aida Cruises	94
AIDAVITA	Aida Cruises	97
Albatross	Phoenix Reissen Cruise Line	91
Allure of the Seas	Royal Caribbean International	97
Amadea	Phoenix Reissen Cruise Line	92
Amsterdam	Holland America Line	96
Anthem of the Seas	Royal Caribbean International	97
Arcadia	P&O Cruises	94
Artania 	Phoenix Reissen Cruise Line	89
Asuka II	"NYK Cruises Co., LTD"	97
Aurora	P&O Cruises	95
Azamara Journey	Azamara Cruises	94
Azamara Quest	Azamara Cruises	99
Azura	P&O Cruises	95
Balmoral	Fred Olsen Cruise Line	93
Braemar	Fred Olsen Cruise Line	95
Bremen	Hapag Lloyd Kreuzfahrten Gmbh	89
Brilliance of the Seas	Royal Caribbean International	96
Britannia	P&O Cruises	95
Caledonian Sky	Salen Ship Management AB	95
Caribbean Princess	Princess Cruises	97
Carnival Breeze	"Carnival Cruise Lines, Inc."	97
Carnival Conquest	"Carnival Cruise Lines, Inc."	89
Carnival Dream	"Carnival Cruise Lines, Inc."	87
Carnival Ecstasy	"Carnival Cruise Lines, Inc."	92
Carnival Elation	"Carnival Cruise Lines, Inc."	100
Carnival Fantasy	"Carnival Cruise Lines, Inc."	88
Carnival Fascination	"Carnival Cruise Lines, Inc."	98
Carnival Freedom	"Carnival Cruise Lines, Inc."	90
Carnival Glory	"Carnival Cruise Lines, Inc."	97
Carnival Imagination	"Carnival Cruise Lines, Inc."	89
Carnival Inspiration	"Carnival Cruise Lines, Inc."	100
Carnival Legend	"Carnival Cruise Lines, Inc."	96
Carnival Liberty	"Carnival Cruise Lines, Inc."	86
Carnival Magic	"Carnival Cruise Lines, Inc."	92
Carnival Miracle	"Carnival Cruise Lines, Inc."	93
Carnival Paradise	"Carnival Cruise Lines, Inc."	96
Carnival Pride	"Carnival Cruise Lines, Inc."	92
Carnival Sensation	"Carnival Cruise Lines, Inc."	92
Carnival Spirit	"Carnival Cruise Lines, Inc."	97
Carnival Splendor	"Carnival Cruise Lines, Inc."	91
Carnival Sunshine	"Carnival Cruise Lines, Inc."	92
Carnival Triumph	"Carnival Cruise Lines, Inc."	78
Carnival Valor	"Carnival Cruise Lines, Inc."	100
Carnival Victory	"Carnival Cruise Lines, Inc."	94
Carnival Vista	"Carnival Cruise Lines, Inc."	92
Celebrity Constellation	Celebrity Cruises	99
Celebrity Eclipse	Celebrity Cruises	100
Celebrity Equinox	Celebrity Cruises	92
Celebrity Infinity	Celebrity Cruises	100
Celebrity Millennium	Celebrity Cruises	98
Celebrity Reflection	Celebrity Cruises	100
Celebrity Silhouette	Celebrity Cruises	96
Celebrity Solstice	Celebrity Cruises	100
Celebrity Summit	Celebrity Cruises	95
Club Med 2	Club Med Marine	89
Coral Princess	Princess Cruises	95
Costa Atlantica	Costa Crociere S.P.A.	97
Costa Deliziosa	Costa Crociere S.P.A.	97
Costa Fortuna	Costa Crociere S.P.A.	93
Costa Luminosa	Costa Crociere S.P.A.	100
Costa Mediterranea	Costa Crociere S.P.A.	94
Crown Princess	Princess Cruises	93
Crystal Serenity	"Crystal Cruises , Inc."	99
Crystal Symphony	"Crystal Cruises , Inc."	90
Diamond Princess	Princess Cruises	98
Disney Dream	Disney Cruise Lines	95
Disney Fantasy	Disney Cruise Lines	99
Disney Magic	Disney Cruise Lines	100
Disney Wonder	Disney Cruise Lines	96
Emerald Princess	Princess Cruises	87
Empress of the Seas	Royal Caribbean International	94
Enchantment of the Seas	Royal Caribbean International	99
Eurodam	Holland America Line	100
Europa	Hapag Lloyd Kreuzfahrten Gmbh	90
Europa 2	Hapag Lloyd Kreuzfahrten Gmbh	90
Explorer of the Seas	Royal Caribbean International	97
Freedom of the Seas	Royal Caribbean International	86
Golden Princess	Princess Cruises	97
Grand Celebration	Bahamas Paradise Cruise Line	98
Grand Princess	Princess Cruises	90
Grande Caribe	Blount Small Ship Adventures	93
Grande Mariner	Blount Small Ship Adventures	95
Grandeur of the Seas	Royal Caribbean International	100
Hanseatic	Hapag Lloyd Kreuzfahrten Gmbh	87
Harmony of the Seas	Royal Caribbean International	94
Independence of the Seas	Royal Caribbean International	90
Island Princess	Princess Cruises	100
Jewel of the Seas	Royal Caribbean International	95
Koningsdam	Holland America Line	97
Kydon	Ferries Del Caribe	61
L'Austral	Compagnie Du Ponant SA	92
Le Boreal	Compagnie Du Ponant SA	84
Le Soleal	Compagnie Du Ponant SA	93
Liberty of the Seas	Royal Caribbean International	96
Maasdam	Holland America Line	96
Majesty of the Seas	Royal Caribbean International	97
Mariner of the Seas	Royal Caribbean International	98
Mein Schiff 6	TUI Cruises GmbH	99
MS Fram	Hurtigruten ASA	92
MS Hamburg	Hamburg Cruise SA	90
MSC Divina	MSC Cruises (Mediterranean Shipping Company)	93
MSC Lirica	MSC Cruises (Mediterranean Shipping Company)	100
MSC Orchestra	MSC Cruises (Mediterranean Shipping Company)	96
MSC Poesia	MSC Cruises (Mediterranean Shipping Company)	87
National Geographic Explorer	Lindblad Expeditions	92
National Geographic Quest	Lindblad Expeditions	94
National Geographic Sea Bird	Lindblad Expeditions	94
National Geographic Sea Lion	Lindblad Expeditions	94
Navigator of the Seas	Royal Caribbean International	100
Nieuw Amsterdam	Holland America Line	96
Noordam	Holland America Line	91
Norwegian Breakaway	Norwegian Cruise Lines	89
Norwegian Dawn	Norwegian Cruise Lines	93
Norwegian Epic	Norwegian Cruise Lines	100
Norwegian Escape	Norwegian Cruise Lines	91
Norwegian Gem	Norwegian Cruise Lines	100
Norwegian Getaway	Norwegian Cruise Lines	95
Norwegian Jade	Norwegian Cruise Lines	97
Norwegian Jewel	Norwegian Cruise Lines	100
Norwegian Pearl	Norwegian Cruise Lines	99
Norwegian Sky	Norwegian Cruise Lines	100
Norwegian Spirit	Norwegian Cruise Lines	100
Norwegian Star	Norwegian Cruise Lines	94
Norwegian Sun	Norwegian Cruise Lines	90
Oasis of the Seas	Royal Caribbean International	97
Ocean Dream	Japan Grace	82
Oceana	P&O Cruises	92
Oceania Insignia	Oceania Cruises	97
Oceania Marina	Oceania Cruises	100
Oceania Regatta	Oceania Cruises	99
Oceania Riviera	Oceania Cruises	99
Oceania Sirena	Oceania Cruises	95
Oosterdam	Holland America Line	94
Oriana	P&O Cruises	90
Pacific Princess	Princess Cruises	95
Pearl Mist	V. Ships Leisure U.S.A.	87
Prinsendam	Holland America Line	94
Quantum of the Seas	Royal Caribbean International	94
Queen Elizabeth	Cunard Line	92
Queen Mary 2	Cunard Line	95
Queen Victoria	Cunard Line	95
Radiance of the Seas	Royal Caribbean International	100
Regal Princess	Princess Cruises	96
Rhapsody of the Seas	Royal Caribbean International	97
Rotterdam	Holland America Line	99
Royal Princess	Princess Cruises	93
Ruby Princess	Princess Cruises	100
Safari Endeavour	Un-Cruise Adventures	94
Safari Quest	Un-Cruise Adventures	88
Sapphire Princess	Princess Cruises	96
Sea Princess	Princess Cruises	97
Seabourn Odyssey	Seabourn Cruise Line	96
Seabourn Pride	Seabourn Cruise Line	96
Seabourn Quest	Seabourn Cruise Line	100
Seabourn Sojourn	Seabourn Cruise Line	93
Seabourn Spirit	Seabourn Cruise Line	93
Seadream I	Sea Dream Yacht Club	100
Seadream II	Sea Dream Yacht Club	97
Serenade of the Seas	Royal Caribbean International	98
Seven Seas Explorer	Regent Seven Seas	100
Seven Seas Mariner 	Regent Seven Seas	94
Seven Seas Navigator 	Regent Seven Seas	97
Seven Seas Voyager	Regent Seven Seas	91
Silver Cloud	Silversea Cruises Ltd	99
Silver Discoverer	Silversea Cruises Ltd	88
Silver Shadow	Silversea Cruises Ltd	95
Silver Spirit	Silversea Cruises Ltd	99
Silver Whisper	Silversea Cruises Ltd	96
Silver Wind	Silversea Cruises Ltd	89
Stad Amsterdam	Rederij Clipper Stad Amsterdam	88
Star Legend	Wind Star Sail Cruises	91
Star Princess	Princess Cruises	95
Sun Princess	Princess Cruises	96
The World	ResidenSea	92
Veendam	Holland America Line	99
Ventura	P&O Cruises	99
Victory I	"Victory I Partners, Ltd., c/o Cruise Mgmt Intl Inc"	78
Viking Sky	Viking Ocean Cruises	95
Viking Star	Viking Ocean Cruises	94
Vision of the Seas	Royal Caribbean International	97
Volendam	Holland America Line	97
Voyager of the Seas	Royal Caribbean International	96
Vspbeta	VSP Office Cruise Line	100
Westerdam	Holland America Line	92
World Odyssey	V. Ships Leisure U.S.A.	95
Zaandam	Holland America Line	95
Zuiderdam	Holland America Line	98
